----------------------------------------------------------------------------------------------------------------------------------------------------------------------------------------------------------
----------------------------------------------------------------------------------------------------------------------------------------------------------------------------------------------------------
----------------------------------------------------------------------------------------------------------------------------------------------------------------------------------------------------------
----------------------------------------------------------------------------------------------------------------------------------------------------------------------------------------------------------
----------------------------------------------------------------------------------------------------------------------------------------------------------------------------------------------------------
----------------------------------------------------------------------------------------------------------------------------------------------------------------------------------------------------------
-----------------------------------------------------------------------------------------SSSSSU-----------------------------------------------------------------------------------------------------------
----------------------------------------------------------------------------------------------------------------------------------------------------------------------------------------------------------
---------------------------------------------------------------------------------------------------------------------#--------------------------------------------#---------------------------------------
---------------------------------------------------------------------------------------------------------------------##------------------------------------------##------------------------SSSS-----------
------!----S@S-------#-----tt---!-----------#------------t---------S---SS--S!--#---@-------t-----SSSS--SS-----t-----###-----------------#-----------------------###------------------------------S!-------
-----------------##--##-----t---------------##-----------t---------------------##----------t------------------tt--#####--##------------##----------------------###-------------t--------------------------
----------------###---##----t--------tt#---###-----------t---------------------##----------t------------------tt-######---#---tt------###---t-----------------####-------------t--------------------------
--------------g####--####---t--------t-#--######---------t-#----g------------####----------t------------g-----t--######--###--tt-----####---t----------------#####----g---g----t------------g-------------
XXXXXXXXXXXXXXXXXXXXXXXXXXXXXXXXXXXXXXXXXXXXXXXXX---XX--XXXXXXXXXXXXXXXXXXXXXXXXXXXXXXXXXXXXXXXXXXXXXXXXXXXXXXXXXXXXXXX--XXXXXXXXXXXXXXXXXXXXXXXXXXXXXXXXXXXXXXXXXXXXXXXXXXXXXXXXXXXXX---XXXXXXXXXXXXXXXXX
XXXXXXXXXXXXXXXXXXXXXXXXXXXXXXXXXXXXXXXXXXXXXXXXX--XXX--XXXXXXXXXXXXXXXXXXXXXXXXXXXXXXXXXXXXXXXXXXXXXXXXXXXXXXXXXXXXXXX--XXXXXXXXXXXXXXXXXXXXXXXXXXXXXXXXXXXXXXXXXXXXXXXXXXXXXXXXXXXXX---XXXXXXXXXXXXXXXXX
