----------------------------------------------------------------------------------------------------------------------------------------------------------------------------------------------------------
----------------------------------------------------------------------------------------------------------------------------------------------------------------------------------------------------------
----------------------------------------------------------------------------------------------------------------------------------------------------------------------------------------------------------
----------------------------------------------------------------------------------------------------------------------------------------------------------------------------------------------------------
----------------------------------------------------------------------------------------------------------------------------------------------------------------------------------------------------------
----------------------------------------------------------------------------------------------------------------------------------------------------------------------------------------------------------
----------------------------------------------------------------------------------------------------------------------------------------------------------------------------------------------------------
----------------------------------------------------------------------------------------------------------------------------------------------------------------------------------------------------------
----------------------------------------------------------------------------------------------------------------------------------------------------------------------------------------------------------
------------------------------------SS-------------------------------------------------------------------------------------------------------#------------------------------------------------------------
------------------------------------------------------t---------------------S!------------------------------------tt--------t---------------##----------S!--------#------t--------------------------------
-------------tt----------------------------------##---------------------------------------------------------------tt--------t-------------####--------------------t------t-----------------t--------------
-------------tt------------------------------t---##--------t------------------------tt-----t------t---tt-----------t--------t---------tt-#####--------------------t------t------------tt---t--------------
-------------tt----#-------------------------t--###---t----t------------------------tt-#---t-#----t---tt-----------t------g-tt-#-------t#######-------------------t------t------------tt---t----------##--
XXX------XXXXXX---XXXXXX---XXXXXXXXXXXXXXXXXXXXXXXXX-XXXXXXXX--XXXXXXXXXXXXXXXXXXXXXXXXXXXXXXXXXXXXXXXXXXXXXXXXXXXXXXXXXXXXXXXXXXXXXXXXXXXXXXXXXX--XXXXXXXXXXXXXXXXXXXXXXXXXXXXXXXXXXXXXXXXXXXXXXXXXXXXXXX
XXX------XXXXXX--XXXXXXX---XXXXXXXXXXXXXXXXXXXXXXXXX-XXXXXXXX--XXXXXXXXXXXXXXXXXXXXXXXXXXXXXXXXXXXXXXXXXXXXXXXXXXXXXXXXXXXXXXXXXXXXXXXXXXXXXXXXXX--XXXXXXXXXXXXXXXXXXXXXXXXXXXXXXXXXXXXXXXXXXXXXXXXXXXXXXX
