----------------------------------------------------------------------------------------------------------------------------------------------------------------------------------------------------------
----------------------------------------------------------------------------------------------------------------------------------------------------------------------------------------------------------
----------------------------------------------------------------------------------------------------------------------------------------------------------------------------------------------------------
----------------------------------------------------------------------------------------------------------------------------------------------------------------------------------------------------------
----------------------------------------------------------------------------------------------------------------------------------------------------------------------------------------------------------
-------------------------------------------#--------------------------------------------------------------------------------------------------------------------------------------------------------------
------------------------------------------##--------------SSSSS--------------SSSSSS-------------------------------------------------------SSSSS--------------SSSSS------------------------------------#---
---------------------#-------------------####----------------------------------------###-------------------------------------------------------------------------------------------------------------##---
--------------------###-----------------#####---------------------------------------####------------------------------------------------------------------------------------------------------------###---
------------------######---------------######--------------------------------------#####---------------------------t-------------------------------------------------------------------------------#------
---------#--------####U#--------------#######----------t---------------------------######----------S!--------------t----S-------------SSSS----S!---t------!---t------------------------------S@----###----
---------#-------U#-####------##--#---#######----------t--------------------------#######--------------------------t-------------------------------t----------t-----------------------------------####----
----###--#--#---##########---###--###########----------t------tt-----------------########--------------------------t-------------------------------t----------t-------------------------t--------#####----
----###--#--t--###########--####--###########----------t-------t-----------g----#########--------#-------------@---t--------------#----------------t----------t-g---------g-------------t-------######----
XXXXXXXXXXXXXXXXXXXXXXXXXXXXXXXX--XXXXXXXXXXXXXXXXXXXXXXXXXXXXXX----#--XXXXXXXXXXXXXXXXXXXXXXXXXXXXXXXXX-XXXXXXXXXXXXXXXXXXXXXXXXXXXXXXXXXXXXXXXXXXXXXXXXXXXXXXXXXXXXXXXXXXXXXXXXXXXXXXXXXXXXXXXXXXXXXX--X
XXXXXXXXXXXXXXXXXXXXXXXXXXXXXXXX--XXXXXXXXXXXXXXXXXXXXXXXXXXXXXXX--XX--XXXXXXXXXXXXXXXXXXXXXXXXXXXXXXXXX-XXXXXXXXXXXXXXXXXXXXXXXXXXXXXXXXXXXXXXXXXXXXXXXXXXXXXXXXXXXXXXXXXXXXXXXXXXXXXXXXXXXXXXXXXXXXXXX-X
