----------------------------------------------------------------------------------------------------------------------------------------------------------------------------------------------------------
----------------------------------------------------------------------------------------------------------------------------------------------------------------------------------------------------------
----------------------------------------------------------------------------------------------------------------------------------------------------------------------------------------------------------
----------------------------------------------------------------------------------------------------------------------------------------------------------------------------------------------------------
----------------------------------------------------------------------------------------------------------------------------------------------------------------------------------------------------------
---------------------------------------------------------------------------------------------------------------------------------------------------------S------------------------------------------------
-----------------------------!-----------------------------------------------------------------------SSSSSSS------------------------------------------------S---------------------------------------------
---------------------------------------------------------------------------------------------------------------------------------------------------------------------------------------------#------------
---------------------------------------------------------------------------------------------------------------------------------------------------------------------------------------------#------------
----------------------------------------------------------------------------------------------------------------------------------------------------------------------------------------##--##------------
----S!---S-------------S!-------#--##----------------------S@--------------US-------!S-!-----------t-----------------SSSSSSS------------------------@#-------@-------U-----!-----------###--##------------
-------------------------------###-##----------------------------------#---------------------t-----t-----------------------------------------------------------------------------------#######------------
------------------------------#######---------------------------------tt---------------------t-----t-------------------------------------t----------------------------------------##--########------------
-----------------------------#########---------------@---##------------t---------------------t-----t-------------------------------------t----------g----------------------------###--########------------
XXXXXXXXXXXXXXXXXXXXXXXXXXXXXXXXXXXXXXXXXXXXXXXXXXXXXXXXXXXXXXXXXXXXXXXXXXXXXXXXXXXXXXXXXXXXXXXXXXXXXXXXXXXXXXXXXXXXXXXXXXXXXXXXXXXXXXXXXXXXXXXXXXXXXXXXXXXXXXX---XXXX--XXXXXXXXXXXXXXXXXXXXXXXXXXXXXXXXXX
XXXXXXXXXXXXXXXXXXXXXXXXXXXXXXXXXXXXXXXXXXXXXXXXXXXXXXXXXXXXXXXXXXXXXXXXXXXXXXXXXXXXXXXXXXXXXXXXXXXXXXXXXXXXXXXXXXXXXXXXXXXXXXXXXXXXXXXXXXXXXXXXXXXXXXXXXXXXXXXX--XXXX--XXXXXXXXXXXXXXXXXXXXXXXXXXXXXXXXXX
