----------------------------------------------------------------------------------------------------------------------------------------------------------------------------------------------------------
----------------------------------------------------------------------------------------------------------------------------------------------------------------------------------------------------------
----------------------------------------------------------------------------------------------------------------------------------------------------------------------------------------------------------
----------------------------------------------------------------------------------------------------------------------------------------------------------------------------------------------------------
----------------------------------------------------------------------------------------------------------------------------------------------------------------------------------------------------------
----------------------------------------------------------------------------------------------------------------------------------------------------------------------------------------------------------
------------------------------------------SSSSSSSS------------------S-----------------------------------------!----------------------------------!----------------SSSSS--!SSS-----------------------------
----------------------------------------------------------------------------------------------------------------------------------------------------------------------------------------------------------
----------------------------------------------------------------------------------------------------------------------------------------------------------------------------------------------------------
------------------------------------------------------t-----------------------------------!---------------------------------------------------------------------------------------------------------------
-----------S@#------t----SSS!S-------t---SS!S---------t-----------!-----------------S!-----------------t--------S--------------!--SS-------------------t-------S!S-------------------------------#--#-----
-------#------------t----------------t----------------t------------------------------------------------t-----------------------------------------------t--------------------------------------------------
-------###----------t----------------t----------------t------------------------------------------------t----------------###----------------------------t----t--------------t------------------------------
---##--####---------t--------g---g---t-g----g---g-----t-----#------------------------------------------t-----------------###-------g----------------g--t----t---gg---------tt--------------------#----g-g-
XXXXX--XXXXXXXXXXXXXXXXXXXXXXXXXXXXXXXXXXXXXXXXXXXXXXXXXXXXXXXXXXXXXXXXXXXXXXXXXXXXXXXXXXXXXX--XXXXXXXXXXXXXXXXXXXXXXXXXXXXXXXXXXXXXXXXX---X--XXXXXXXXXXXXXXXXXXXXXXXXXXXXXXXXXXXXXXXX--XXXXXXXXXXXXXXXXXX
XXXXXX-XXXXXXXXXXXXXXXXXXXXXXXXXXXXXXXXXXXXXXXXXXXXXXXXXXXXXXXXXXXXXXXXXXXXXXXXXXXXXXXXXXXXXX--XXXXXXXXXXXXXXXXXXXXXXXXXXXXXXXXXXXXXXXXX---X--XXXXXXXXXXXXXXXXXXXXXXXXXXXXXXXXXXXXXXXXXXXXXXXXXXXXXXXXXXXX
