----------------------------------------------------------------------------------------------------------------------------------------------------------------------------------------------------------
----------------------------------------------------------------------------------------------------------------------------------------------------------------------------------------------------------
----------------------------------------------------------------------------------------------------------------------------------------------------------------------------------------------------------
----------------------------------------------------------------------------------------------------------------------------------------------------------------------------------------------------------
----------------------------------------------------------------------------------------------------------------------------------------------------------------------------------------------------------
----------------------------------------------------------------------------------------------------------------------------------------------------------------------------------------------------------
---------------------------------------------------SS----SSSS-------------------------------------------------------------------------SSSSSS---------------------------------------------------------!----
----------------------------------------------------------------------------------------------------------------------------------------------------------------------------------------------------------
----------------------------------------------1-----------------------------------------------------#----#-----------------------------------------------------#------------------------------------------
---------------------------------------------#1--------------------------------------------------####--###------------------------------#----------------------#---------------------------#--------------
---------@----------#----###----------------S#1------------#------US-------t---@----------------###-######-----------------S#----------##--##--#---------------U------------S!-------------#-----#--------
--------------------#----###---------------####------------t---------------t------------t------###--######---------------------------####--##--#----------------------------------------#--#--------------
--------------------#----###---t----------#####------------t---------------t------------t-----####--#######--------#----------------#####--##--#------------------------------------tt-##-----------------
-------------------####-#####------------########----------t---------------t------------t---#################----g-#---------------######--##--##----------#----g-----##------------tt###-----#--g--------
XXXXXXXXXXXXXXXXXXXXXXXXXXXXXXXX--XXXXXXXXXXXXXXXX--#--XXXXX--XXXXXXXXXXXXXXXXXXXXXXXXXXXXXXXXXXXXXXXXXXXXXXXXXXXXXXXXXXXXXXXXXXXXXXXXXXXXXXX--XXXXXXXXX---XXXXXXXXXXXXXXXXXXXXXXXXXXXXXX--XXXXXXXXXXXXXXX
XXXXXXXXXXXXXXXXXXXXXXXXXXXXXXXX--XXXXXXXXXXXXXXXX--X--XXXXX--XXXXXXXXXXXXXXXXXXXXXXXXXXXXXXXXXXXXXXXXXXXXXXXXXXXXXXXXXXXXXXXXXXXXXXXXXXXXXXX--XXXXXXXXXX--XXXXXXXXXXXXXXXXXXXXXXXXXXXXXXX-XXXXXXXXXXXXXXX
