----------------------------------------------------------------------------------------------------------------------------------------------------------------------------------------------------------
----------------------------------------------------------------------------------------------------------------------------------------------------------------------------------------------------------
----------------------------------------------------------------------------------------------------------------------------------------------------------------------------------------------------------
----------------------------------------------------------------------------------------------------------------------------------------------------------------------------------------------------------
----------------------------------------------------------------------------------------------------------------------------------------------------------------------------------------------------------
----------------------------------------------------------------------------g-----------------------------------------------------------------------------------------------------------------------------
--------------------------------------------------SSS-----SSSSS-----------SSSSSS---------!S-----------------------------------------------------------------------------SS!-------------------------------
-----------------------------------------------#--!U-------------------------------------------------------------------------------------SS---------------------------------------------------------------
----------------------------------------------------------------------------------------------------------------------------------------------------------------------------------------------------##----
----------------------------------------------------------------------------------------------------#-------------------------------------------------------------------------------------#--------###----
------------------------------!-------------------------U-------------------------------t-------t--------!-----SU----------------#----------------------------------SUSS-----------------###--#---#1##----
------------------------------------------------------------------------------------------------t--------------------------------t---------------------------------------------------t---###------#####---
-----#--##---t-------------------------------#---------------t----------t------------#--##------t--------------------------------t----------------#---------#-----------------t------t--####-----######---
----##--##---t------------------------##----###--------------t-----g----t##---------##--###-----t--------------------------------t-##-------------t--------##-----------------t-#-g--t-#####----#######---
--XXXX--XXXXXXXXXXXXXXXXXXXXXXXXXXXXXXXXXXXXXXXXXXXXXXXXXXXXXXXXXXXXXXXXXXXXXXXXXXXXXX-XXXXXXXXXXXXXXXXXXXXXXXXXXXXXXXXXXXXXXXXXXXXXXXXXX--XXXXXXXXXXXX--XXXXXXXXXXXXXXXXXXXXXXXXXXXXXXXXXXXXXXXXXXXXXXXXX
--XXXX--XXXXXXXXXXXXXXXXXXXXXXXXXXXXXXXXXXXXXXXXXXXXXXXXXXXXXXXXXXXXXXXXXXXXXXXXXXXXXXXXXXXXXXXXXXXXXXXXXXXXXXXXXXXXXXXXXXXXXXXXXXXXXXXXX--XXXXXXXXXXXX--XXXXXXXXXXXXXXXXXXXXXXXXXXXXXXXXXXXXXXXXXXXXXXXXX
