----------------------------------------------------------------------------------------------------------------------------------------------------------------------------------------------------------
----------------------------------------------------------------------------------------------------------------------------------------------------------------------------------------------------------
----------------------------------------------------------------------------------------------------------------------------------------------------------------------------------------------------------
----------------------------------------------------------------------------------------------------------------------------------------------------------------------------------------------------------
----------------------------------------------------------------------------------------------------------------------------------------------------------------------------------------------------------
----------------------------------------------------------------------------------------------------------------------------------------------------------------------------------------------------------
------------------------------------------------------------------SSSSS-----------------------------------------------S!S------------------------------------------------------------------SSSSSSS--------
--------------------------------------------------------------------------------###--##-------------------------------------------------------------------------------------------------------------------
-------------------------------------------------------------------------------#####S#--------------------------------------------------------------------------------------------------------------------
-------------------------------##----------------------------------------------####S##----------U---------------------------------------------------------------------------------------------------------
-----------------S-------t----###------------g---------------S!-----SS----#---########---------------------------#---------------------------------------t---------------------tt-----S@S-----------------
------------t------------t----###-----------------------------------------t---########----t---------------tt----tt-----------------------------t---------t----------------------t-------------------------
--------#---t------------t---####-----t-----------------------------------t---########----t----------t----tt----tt-----#--#--------------------t---------t----------------#-----t-------------------------
------###---t------------t--######----t-----------g------g-------------g--t---########---#t-g--------t-----t----tt-----#--###----g-------------t---------t----------------##----t-------------------------
XXXXXXXXXXXXXXXXXXXXXXXXXXXXXXXXXXXXXXXXXXXXXXXXXXXXXXXXXXXXXXXXXXXXXXXXXXXXXXXXXXXXXX---XXXXXXX--XXXXXXXXXXXXXXXXXXXXXX--XXXXXXXXXXXXXXXXXXXXXXXXXXXXXXXXXXXXXXXXX--XXXXXXXXXXXXXXXXXXXXXXXXXXXXXXXXXXXXX
XXXXXXXXXXXXXXXXXXXXXXXXXXXXXXXXXXXXXXXXXXXXXXXXXXXXXXXXXXXXXXXXXXXXXXXXXXXXXXXXXXXXXX---XXXXXXXXXXXXXXXXXXXXXXXXXXXXXXXX-XXXXXXXXXXXXXXXXXXXXXXXXXXXXXXXXXXXXXXXXX--XXXXXXXXXXXXXXXXXXXXXXXXXXXXXXXXXXXXX
