----------------------------------------------------------------------------------------------------------------------------------------------------------------------------------------------------------
----------------------------------------------------------------------------------------------------------------------------------------------------------------------------------------------------------
----------------------------------------------------------------------------------------------------------------------------------------------------------------------------------------------------------
----------------------------------------------------------------------------------------------------------------------------------------------------------------------------------------------------------
----------------------------------------------------------------------------------------------------------------------------------------------------------------------------------------------------------
----------------------------------------------------------------------------------------------------------------------------------------------------------------------------------------------------------
----------------------------------------SSS----------------------SSS--------------------------------------SS------------------------------------#--SSSSSSS-----------SS-----------------------------------
-----------------------------------#-----------------------------------------------------------------------------------------------------------##------------------------------!S-------------------------
----------------------------------##-----------------------------------------------------------------------------------------------------------##---------------------------------------------------------
---------------------------------###----------------------------------------------------------------------------------------------------------US----------------------------------------------------------
----t----!S----------###----SU--####---S!---t-----------------SSS-----------S-----g--------------------------------------US-----------!------#---#-------@---------------SS!--#---U------!--------S!------
----t---------------####-------#####--------t---------------------------------------------------------#-----t------------------------------###---##---------------t----------##---------------------------
----t-----------t--#####-------##--1--------t---t--------t-----------tt--------------------------###--------t-----t--------------------t--####---###--------------t---------###-----------------------t---
----t-----------t-#######-----###--##-------t---t--------t-----------tt-----#-------##----------####--------t-----t--------------------t--####---####--------g----t--------####-----------------------t---
XXXXXXXXXXXXXXXXXXXXXXXXXXXXXXXXX-XXXXXXXXXXXXXXXXXXXXXXXXXXXXXXXXXXXXXXXXXXXXXXXXXXXX--XXXXXXXXXXXXXXXXXXXXXXXXXXXXXXXXXXXXXXXXXXXXXXXXXXXXXXX--XXXXXXXXXXXXXXXXXXXX--XXXXXXXXXXXXXXXXXXXXXXXXXXXXXXXXXXX
XXXXXXXXXXXXXXXXXXXXXXXXXXXXXXXXX-XXXXXXXXXXXXXXXXXXXXXXXXXXXXXXXXXXXXXXXXXXXXXXXXXXXX--XXXXXXXXXXXXXXXXXXXXXXXXXXXXXXXXXXXXXXXXXXXXXXXXXXXXXXX--XXXXXXXXXXXXXXXXXXXX--XXXXXXXXXXXXXXXXXXXXXXXXXXXXXXXXXXX
