----------------------------------------------------------------------------------------------------------------------------------------------------------------------------------------------------------
----------------------------------------------------------------------------------------------------------------------------------------------------------------------------------------------------------
----------------------------------------------------------------------------------------------------------------------------------------------------------------------------------------------------------
----------------------------------------------------------------------------------------------------------------------------------------------------------------------------------------------------------
----------------------------------------------------------------------------------------------------------------------------------------------------------------------------------------------------------
----------------------------------------------------------------------------------------------------------------------------------------------------------------------------------------------------------
----------------------------------------------------------------!S--SSS-----------------------------------------------------------------------------------------------------------------------------------
----------------------------------------------------------------------------------------------------------------------------------------------------------------------------------------------------------
----------------------------------------------------------------------------------------------------------------------------------------------------------------------------------------------------------
--------------S--------------------------##--#--------------------------------------------------#---------------------------------------------------------------------------------------------------------
-----------#---------------S!------------##--#--------------------#----------------#---S@S-----###----------S@!---------S!--S!S------------tt-----------------------------#---------S---t------S---t------
-----------#-------------------------#----#--#------------------------------------###---------####-----###----------------------------------t-----------------------------##--tt--------t----------tt-----
----t----###------------------------###--##--#-----------------------------t-----####--------#####-----####---------------------------------t--#--------#-------------#---##--tt--------t----------tt-----
----t---#####----------------------########--------------------------------t----######------#######----#####---------------------------g----t-##-------###------------t--###---t--------t-----g----t--g---
XXXXXXXXXXXXXXX--XXXXXXXXXXXX-XX---XXXXXXXXXXXXXXX---XXXXXXXXXXXXXXXXXXXXXXXXXXXXXXXXXXXXXXXXXXXXXXXXXXXXXXXXXXXXXXXXXXXXXXXXXXXXXXXXXXXXXXXXXX#--XXXXXXXXXXXXXXXXXXXXXXXXXXXXXXXXXXXXXXXXXXXXXXXXXXXXXXXX
XXXXXXXXXXXXXXX--XXXXXXXXXXXX-XX---XXXXXXXXXXXXXXXX--XXXXXXXXXXXXXXXXXXXXXXXXXXXXXXXXXXXXXXXXXXXXXXXXXXXXXXXXXXXXXXXXXXXXXXXXXXXXXXXXXXXXXXXXXXX--XXXXXXXXXXXXXXXXXXXXXXXXXXXXXXXXXXXXXXXXXXXXXXXXXXXXXXXX
