----------------------------------------------------------------------------------------------------------------------------------------------------------------------------------------------------------
----------------------------------------------------------------------------------------------------------------------------------------------------------------------------------------------------------
----------------------------------------------------------------------------------------------------------------------------------------------------------------------------------------------------------
----------------------------------------------------------------------------------------------------------------------------------------------------------------------------------------------------------
----------------------------------------------------------------------------------------------------------------------------------------------------------------------------------------------------------
----------------------------------------------------------------------------------------------------------------------------------------------------------------------------------------------------------
-----------------------------#--------------------SSSSS---------------------------------------------------------------------------------------------------------------------------------------------------
----------------------------#---------------------------------------------------------------------------------------------------------------------------------------------------------------##------------
---------------------------##---------------------------------------S----------------------------------------------------------------------------------------------------------------------###------------
--------------------------###-----------------------------------------------------------------------------------------------------------------------#------------------------------------#####------------
---@----------------------###----------------------!--SUS---SSSSSSS---------------S------SUSS--S!SS---t-----#----------S@-------SS----------------###---!------!----SUS-----------------###U11###---#-----
-------------------------####-------------------------------------------------------------------------t------#-----------------------------------####----------------------------------#U########---#-----
------------------------#####-------------t----------------------------t------------------------------t--#----#------------------------tt-------####----------------------------------###########--##-----
--------g--------------######----g--------t----------------------------t------------------------------t-###--###-----------g-----------t-------######--------------------------------#################----
XXXXXXXXXXXXXX---XXXXXXXXXXXXXXXXXXXXXXXXXX#---XXXXXXXXXXXXXXXXXXXXXXXXXXXXX--XXXXXXXXXXXXXXXXXXXXXXXXXXXXX--XXXXXXXXXXXXXXXXXXXXXXXXXXXXXXXXXXXXXXXXXXXXXXXXXXXXXXXXXXXXXXXXXXXXXXXXXXXXXXXXXXXXXXXXXXXXX
XXXXXXXXXXXXXX---XXXXXXXXXXXXXXXXXXXXXXXXXXX---XXXXXXXXXXXXXXXXXXXXXXXXXXXXX--XXXXXXXXXXXXXXXXXXXXXXXXXXXXX--XXXXXXXXXXXXXXXXXXXXXXXXXXXXXXXXXXXXXXXXXXXXXXXXXXXXXXXXXXXXXXXXXXXXXXXXXXXXXXXXXXXXXXXXXXXXX
