----------------------------------------------------------------------------------------------------------------------------------------------------------------------------------------------------------
----------------------------------------------------------------------------------------------------------------------------------------------------------------------------------------------------------
----------------------------------------------------------------------------------------------------------------------------------------------------------------------------------------------------------
----------------------------------------------------------------------------------------------------------------------------------------------------------------------------------------------------------
----------------------------------------------------------------------------------------------------------------------------------------------------------------------------------------------------------
----------------------------------------------------------------------------------------------------------------------------------------------------------------------------------------------------------
----------------------------------------------------SSSS-----------------------------------------------------SSSSSS---------------------SSSSS----------------SSSSSSSU-------------------------------------
----------------------------------------------------------------------------------------------------------------------------------------------------------------------------------------------------------
-------------------------------------------------------------------------------------------------------------##-------------------------------------------------------------------------------------------
-------------------------------------------------------------------------------------------------------------##-------------------------------------------------------------------------------------------
----------------------S------------------S@-------------------#------------!----!---------------------------###-----------SS---t-----------------t------------------S!----------------------S!S!SS!S------
--------------------------------------------------------------t----t---------------------------------------#-##----------------t----------------tt----t---------------------------------------------------
--------------------------------------------------------------t----t---------------------tt---t-------t---#--###---------------t----------------tt----t-----------------------------##--------------------
------------g-------------------------------------------------t----t-##-------------------t---t-#-----t---##-####----g---------t-g---##---------tt----t-------------------g--------###-------------------#
XXXXXXXXXXXXXXXXXXXXXXXXXXXXXXXXX--XXXXXXXXXXXXXXXX--XXXXXXXXXXXXXXXXXXXXXXXXXXXXXXXXXXXXXXXXXXXXXXXXXXXXXXXXXXXXXXXXXXXXXXXXXXXXXXXXXXXXXXXXXXXXXXXXXXXXXXXXXXXXXXXXXXXXXXXXXXXXXXXXXXXXXXXXXXXXXXXXXXXXX
XXXXXXXXXXXXXXXXXXXXXXXXXXXXXXXXX--XXXXXXXXXXXXXXXX--XXXXXXXXXXXXXXXXXXXXXXXXXXXXXXXXXXXXXXXXXXXXXXXXXXXXXXXXXXXXXXXXXXXXXXXXXXXXXXXXXXXXXXXXXXXXXXXXXXXXXXXXXXXXXXXXXXXXXXXXXXXXXXXXXXXXXXXXXXXXXXXXXXXXX
