----------------------------------------------------------------------------------------------------------------------------------------------------------------------------------------------------------
----------------------------------------------------------------------------------------------------------------------------------------------------------------------------------------------------------
----------------------------------------------------------------------------------------------------------------------------------------------------------------------------------------------------------
----------------------------------------------------------------------------------------------------------------------------------------------------------------------------------------------------------
----------------------------------------------------------------------------------------------------------------------------------------------------------------------------------------------------------
----------------------------------------------------------------------------------------------------------------------------------------------------------------------------------------------------------
--------------------------------------------------------------------------S-------------------SSSS-----------------------------##---------------------S!-----------!S---SSSSSSSSSSS-----------------------
-------------------------------------------------------------------------------------------------------------------------------##-------------------------------------------------------------------------
-------------------------------------------------------------------------------------------------------------------------------##-------------------------------------------------------------------------
-------------------------------------------------------------------------------------------------------------------------------##-------------------------------------------------------------------------
-----@-----tt-----------------------------------------------------@--------SS!----#------t-----------------!-----t----SS-----SU#--------------S------------S!--------S!-----------------------------------
-----------tt------------------------tt-------------------------------------------t------t-----------------------t----------------------------------------------------------------------------------------
-----------tt----------t-------------tt-------------------------------------------t------t---------t-------------t--------------------###-----------#-----------------------------------------------------
##-----g----t----------t--------------t-----------------------------------####----t------t---------t-------------t-------------------####----------###------------------------g------------g-----#--------
XXXXXXXXXXXXXXXXXXXXXXXXXXXXXXXXXXXXXXXXXXXXXXXXXXXXXXXXXXXXXXXXXXXXX---XXXXXXXXXXXXXXXXXXXXXXXXXXXXXXXXXXXXXXXXXXXXXXXXXXXXXXXXXXXXXXXXXXXXXXXXXXXXXX--XXXXXXXXXXXXXXXXX---XXXX--XXXXXXXXXXXXX--XXXXXXXXX
XXXXXXXXXXXXXXXXXXXXXXXXXXXXXXXXXXXXXXXXXXXXXXXXXXXXXXXXXXXXXXXXXXXXX---XXXXXXXXXXXXXXXXXXXXXXXXXXXXXXXXXXXXXXXXXXXXXXXXXXXXXXXXXXXXXXXXXXXXXXXXXXXXXX--XXXXXXXXXXXXXXXXXX--XXXXXXXXXXXXXXXXXXX--XXXXXXXXX
