----------------------------------------------------------------------------------------------------------------------------------------------------------------------------------------------------------
----------------------------------------------------------------------------------------------------------------------------------------------------------------------------------------------------------
----------------------------------------------------------------------------------------------------------------------------------------------------------------------------------------------------------
----------------------------------------------------------------------------------------------------------------------------------------------------------------------------------------------------------
----------------------------------------------------------------------------------------------------------------------------------------------------------------------------------------------------------
----------------------------------------------------------------------------------------------------------------------------------------------------------------------------------------------------------
----------------------------------------------------SSSSSS-------------------------------SSSSSS---------------------------------------------------------------#--------------------------------@----------
--------------------------------------------------------------------------------------------------------------------------------------------------------------------SSSS----------------------------------
---------------------------------------------------------------#------------------------------------------------------------------------------------------------------------------------------------------
----------------------------------------------#---------------##--------------------------------------------------#--------------------------------------------------------------------------------##-----
-----S---SS----------------------------------##--------------###----------------------SSSS----------t------------##-------------t-----S!------------!S------S!SUS---------------------------t-------------
---------------------------t----------------###----t--------####------t-----------------------t-----t-----------###-------------t-----------------------------------------------------------t-------------
---------------------------t----t--------tt####----t-------#####------t-----------------------t-----t---------#####-----tt------t------------------------------------------------------------#------------
---------------------------t#------------t######--###-----#######-----t-----g-----------------t-----t--------######------t-#----t-#------------------------------------------t----------#---####------g---
XXXXXXXXXXXXXXXXXXXXXXXXXXXXXXXXXXXXXXXXXXXXXXXX-XXXX--XXXXXXXXXXXXXXXXXXXXXXXXXXXXXXXXXXXXXXXXXXXXXXXXXXXXXXXXXXXXXXXXXXXXXXXXXXXXXXXXXXX--XXXXXXXXXX--XXXXXXXXXXXXXXXXXXXXXXXXXXXXXXXXXX--XXXXXXXXXXXXXX
XXXXXXXXXXXXXXXXXXXXXXXXXXXXXXXXXXXXXXXXXXXXXXXXXXXXX--XXXXXXXXXXXXXXXXXXXXXXXXXXXXXXXXXXXXXXXXXXXXXXXXXXXXXXXXXXXXXXXXXXXXXXXXXXXXXXXXXXX--XXXXXXXXXXX-XXXXXXXXXXXXXXXXXXXXXXXXXXXXXXXXXX--XXXXXXXXXXXXXX
