----------------------------------------------------------------------------------------------------------------------------------------------------------------------------------------------------------
----------------------------------------------------------------------------------------------------------------------------------------------------------------------------------------------------------
----------------------------------------------------------------------------------------------------------------------------------------------------------------------------------------------------------
----------------------------------------------------------------------------------------------------------------------------------------------------------------------------------------------------------
----------------------------------------------------------------------------------------------------------------------------------------------------------------------------------------------------------
----------------------------------------------------------------------------------------------------------------------------------------------------------------------------------------------------------
------------------------##-------------------------------------#!----------------!!-------#!SS------------------------------------------------------------------SSSSSSSS---!---------------SSSSSS---------
----------------------####--------------------------------------------------------------------------------------------------------------------------------------------------------------------------------
---------------------#####-------------------------------------------------------------------------------!------------------------------------------------------------------------------------------------
--------------------######----------------------------------------------------------------------------------------------------------------------------------------#---------------------------------------
-------------------#######-------------------------------#---------------!----------------!-----##-------------------CS!S-----##--------------S!----SU------#---###---@--------------t------S!S------g----
------------------########-------------------------------t------------------------------------####---------------------------###-------------------------------####------------t-----t--------------------
--------#---###--#########-------------------------------t-----------------------------------#####------------tt---#--------####--#-----------------t-------tt#####------------t-----t--------------------
-------##---###--#########-------------------------------t-----g----gg----------------------######-------------t--S#----g--####---##----------------t-------t-#####------------t-#---t--------------------
XXXXXXXXXX-XXXXXXXXXXXXXXXXXXXXXXXXXXXXXXXXXXXXXXXXXXXXXXXXXXXXXXXXXXXXXXX---X---XXXXXXXXXXXXXXXXXXXXXXXXXXXXXXXXXXXXXXXXXXXXXXX--XXXXXXXXXXXXXXXXXXXXXXXXXXXXXXXXXXXXXXXXXXXXXXXX-XXXXXXXXXXXXXXXXXXXXXXX
XXXXXXXXXX-XXXXXXXXXXXXXXXXXXXXXXXXXXXXXXXXXXXXXXXXXXXXXXXXXXXXXXXXXXXXXXXX--XX--XXXXXXXXXXXXXXXXXXXXXXXXXXXXXXXXXXXXXXXXXXXXXXX-XXXXXXXXXXXXXXXXXXXXXXXXXXXXXXXXXXXXXXXXXXXXXXXXXXXXXXXXXXXXXXXXXXXXXXXXX
