----------------------------------------------------------------------------------------------------------------------------------------------------------------------------------------------------------
----------------------------------------------------------------------------------------------------------------------------------------------------------------------------------------------------------
----------------------------------------------------------------------------------------------------------------------------------------------------------------------------------------------------------
----------------------------------------------------------------------------------------------------------------------------------------------------------------------------------------------------------
----------------------------------------------------------------------------------------------------------------------------------------------------------------------------------------------------------
----------------------------------------------------------------------------------------------------------------------------------------------------------------------------------------------------------
-----SSSSSSSSSSSSSSSSSS----------------------------------------@!S---------------------------------------------------------------------------------------------------------------------------S!SS---------
------------------------------------------------------------------------------SS--------------------------------------------------------------------------------------------------------------------------
----------------------------------------------------------------------------------------------------------------------------------------------------------------------------------------------------------
---------------------------------##------------------------------------------------#----------------------------------------------------------------------------------------------------------------------
---U---------------------!------###----------------------#-----------------t------------S!-------------------!-------------U-----#---------------S@-------------------t------S!-------t---------------t---
-------------tt----------------####---------------------##---------#-------t----------------------------------------------------####----------------------------------t---------------t---------------t---
-------------tt--------------######--------------------###----#----t-------t-----tt----------tt--------------------------------##-###----------------------tt---------t---------------t---------------t---
-------------tt##---g-------########------------------####---S###--t--#----t-g---tt----------t-----------g-----------------g--##--####---------------------t----------t#----------#---t-#-------------t--#
XXXXXXXXXXXXXXXXXXXXXXXXXXXXXXXXXXXXXXXXXXXXXXXXXXXXXXXXXX--XXXXXXXXXXXXXXXXXXXXXXXXXXXXXXXXXXXXXXXXXXXXXXXXXXXXXX---XXXXXXXXXXXX-#XXXXX--XXXXXXXXXXXXX---XXXXXXXXXXXXXXXXXXXXXXXXX--XXXXXXXXXXXXXXXXXXXXX
XXXXXXXXXXXXXXXXXXXXXXXXXXXXXXXXXXXXXXXXXXXXXXXXXXXXXXXXXX--XXXXXXXXXXXXXXXXXXXXXXXXXXXXXXXXXXXXXXXXXXXXXXXXXXXXXXX--XXXXXXXXXXXX-XXXXXX--XXXXXXXXXXXXX---XXXXXXXXXXXXXXXXXXXXXXXXXX-XXXXXXXXXXXXXXXXXXXXX
