----------------------------------------------------------------------------------------------------------------------------------------------------------------------------------------------------------
----------------------------------------------------------------------------------------------------------------------------------------------------------------------------------------------------------
----------------------------------------------------------------------------------------------------------------------------------------------------------------------------------------------------------
----------------------------------------------------------------------------------------------------------------------------------------------------------------------------------------------------------
----------------------------------------------------------------------------------------------------------------------------------------------------------------------------------------------------------
----------------------------------------------------------------------------------------------------------------------------------------------------------------------------------------------------------
----------------!-----------------------SSSSSSS----------------SSSSSS#------------------------------------------------------------------#SSSSS--------------SSSSSS---###--SSSS-------------S--------------
------------------------------------------------------------------------------------------------------S-------------------------------###---------------------------####----------------------------------
-------------------------------------------------------------------------------------------------------------------------------------####--------------------------#####----------------------------------
----------------------------------------------------------#-------------------------------------------------------------------------####--------------------------######----------------------------------
----SS-----@---------------t-----------------------------##--------------------------------------SS---S---@----------------U!-----######-------------------------#######--------------------S-------------
---------------------------t----------------------------###---------------------------##------------------------t----------------t1U####------------------------########----------------------------------
---------------------tt----t---------------------------###---#------------tt-------#--###-----------------------t---------------########-----------------------#########----t--------tt-------------------
----------------------t----t-------------------------#####---###----------tt-----###--####---------------------tt--------------########-----------------t-----##########----tt-------tt-------------g-g---
XXXXXXXXXXXXXXXXXXXXXXXXXXXXXXXXXXXXXXXXXXXXXXXXXXXXXXXXXXX--XXXXXXXXXXXXXXXXXXXXXXXXXXXXXX--XXXXXXXXXXXXXXXXXXXX---XX--XXXXXXXXXXXXXXXXXXXXXXXX---XXXXXXXXXXXXXXXXXXXXXXXXXXXXXXXXXXXXXXXXXXXXXXXXXXXXXXX
XXXXXXXXXXXXXXXXXXXXXXXXXXXXXXXXXXXXXXXXXXXXXXXXXXXXXXXXXXX-XXXXXXXXXXXXXXXXXXXXXXXXXXXXXXX--XXXXXXXXXXXXXXXXXXXX---XX--XXXXXXXXXXXXXXXXXXXXXXXX---XXXXXXXXXXXXXXXXXXXXXXXXXXXXXXXXXXXXXXXXXXXXXXXXXXXXXXX
