----------------------------------------------------------------------------------------------------------------------------------------------------------------------------------------------------------
----------------------------------------------------------------------------------------------------------------------------------------------------------------------------------------------------------
----------------------------------------------------------------------------------------------------------------------------------------------------------------------------------------------------------
----------------------------------------------------------------------------------------------------------------------------------------------------------------------------------------------------------
----------------------------------------------------------------------------------------------------------------------------------------------------------------------------------------------------------
----------------------------------------------------------------------------------------------------------------------------------------------------------------------------------------------------------
---------SSSS-----------------------------------------------------------------------SS-----------------------SSSSSS---------------------------------------------------------------------------------------
-----------------------------------------------------------------------------------------------------------------------------------------------------------------------------------------------SS---------
--------------------------------------------------------------------------------------------------#-##----------------------------------------------------------------------------------------------------
-------------------------------------------------------------------------------------------------##-##----------------------------------------------------------------------------------------------------
-----------------------S------------t-------------------------------S@-----U!---tt--------------###--#-----------------@----S-------------------!-----------------#-----------S---------------------------
------------#-----------------------t-------------------------------------------tt------------t--##--1------------------------------------------------------------t---------------------------------------
------------t-----------------------t---------#---------------------------------tt------t-----t-###--#-------t---t--------------t---tt----------------------##----t---------------------------------------
-----g------t-----------------------t---------t---------------------------------tt------t-----t-##---#-------t---t--------------t---tt-#----g-------g-g----####---t---------g--------------------g--------
XXXXXXX---XXXXXXXXXXXXXXXXXXXXXXXXXXXXXXXXXXXXXXXXXXX--XX-XXXXXXXXXXXXXXXXXXXXXXXXXXXXXXXXXXXXXXXXX-XXXXXXXXXXXXXXXXXXXXXXXXXXXXXXXXXXXXXXXXXXXXXXXXXXXXXXXXXXXXXXXXXXXXXXXXXXXXXXXXXXXXXXXXXXXXXXXXXXXXXX
XXXXXXXX--XXXXXXXXXXXXXXXXXXXXXXXXXXXXXXXXXXXXXXXXXXX--XXXXXXXXXXXXXXXXXXXXXXXXXXXXXXXXXXXXXXXXXXXX-XXXXXXXXXXXXXXXXXXXXXXXXXXXXXXXXXXXXXXXXXXXXXXXXXXXXXXXXXXXXXXXXXXXXXXXXXXXXXXXXXXXXXXXXXXXXXXXXXXXXXX
