----------------------------------------------------------------------------------------------------------------------------------------------------------------------------------------------------------
----------------------------------------------------------------------------------------------------------------------------------------------------------------------------------------------------------
----------------------------------------------------------------------------------------------------------------------------------------------------------------------------------------------------------
----------------------------------------------------------------------------------------------------------------------------------------------------------------------------------------------------------
----------------------------------------------------------------------------------------------------------------------------------------------------------------------------------------------------------
----------------------------------------------------------------------------------------------------------------------------------------------------------------------------------------------------------
-------SSSS--------SSSSS----------------!@@S--------------------------------------------SSSSU-------------------------------------------------------------------------------------------------------------
----------------------------------------------------------------------------------------------------------------------------------------------------------------------------------------------------------
--------------------S----#--------------------------------------------------------------------------------------------------------------------------------------------------------------------------------
-------------------------#--------------------------------------------------------------------------------------------------------------------------------------------------------------------------------
----------S!S!S!S-SSSSSSU!-------------------------------S!------S!-----S---------------------------S!------##------------------S----S@S----t-----S!---------------##--#----------------S@---@------------
--------------------------------t-------------t------------------------------------------------------------##-------------t-----------------t-----------------t---###--##------t--------------------------
--------------------------------t-------------t-----------------------------------------------------------###--------t----t-----------------t-----------------t--####--###-----t--------------------t-----
--------------------------------t--------g---tt-------------------------g--------------------------g-----####--------t----t--g--------------t-----------gg----t-#####--####--gt---------------------t-----
X--XXXXXXXXXXXXXXXXXXXXXXXXXXXXXXXXXXXXXXXXXXXXXX--XXXXXXXXXXXXXXXXXXXXXXXXXX--XX---XXXXXXXXXXXXXXXXXXXXXXXXXXXXXXXXXXXXXXXXXXXXXXXXXXXXXXXXXXXXXXXXXXXXXXXXXXXXXXXXXXXXXXXXXXXX--XXXXXXXXXXXXXXXXXXXXXXXX
X--XXXXXXXXXXXXXXXXXXXXXXXXXXXXXXXXXXXXXXXXXXXXXX--XXXXXXXXXXXXXXXXXXXXXXXXXXXXXX---XXXXXXXXXXXXXXXXXXXXXXXXXXXXXXXXXXXXXXXXXXXXXXXXXXXXXXXXXXXXXXXXXXXXXXXXXXXXXXXXXXXXXXXXXXXX--XXXXXXXXXXXXXXXXXXXXXXXX
