----------------------------------------------------------------------------------------------------------------------------------------------------------------------------------------------------------
----------------------------------------------------------------------------------------------------------------------------------------------------------------------------------------------------------
----------------------------------------------------------------------------------------------------------------------------------------------------------------------------------------------------------
----------------------------------------------------------------------------------------------------------------------------------------------------------------------------------------------------------
----------------------------------------------------------------------------------------------------------------------------------------------------------------------------------------------------------
---------------------------------------g------------------------------------------------------------------------------------------------------------------------------------------------------------------
------------------SSSSSSSSS----------SSSSSS-------------------------------------------------------------------------------------------------SSSSS--------SSSSS-------------------S!SSSS--------SS---------
----------------------------------------------------------------------------------------------------------------------U-----------------------------------------------------------------------------------
----------------------------------------------------------------------------------------------------------------------------------------------------------------------------------------------------------
-------##-----------------------------------------------------------------------------------#-------------------------------------------------------------------------------------------------------------
------###---------------------t---------SS-----SSSS----------t----U-----------------------###-------t-----SSS------#--#------------------t-----------SUS------------------------------U-------------------
-----####---------------------t------------------------------t--------------------------#####-------t-------------##------------t--------t--------------------------------t------##-----------------------
----#####---t-----1#----------t------------------------------t-------------------------####-##------t------------###--U#--------t--------t----t---------------------------t-----###-----------------------
---#######--t-#---####--------t------------------g-----------t------------------------####--###-----t-----------###---1#--------t--------t----t---------------------------t-#--####------g----------------
--#XXXXXXXXXXXXXXXXXXXXXXXXXXXXXXXXXXXXXXXXXXXXXXXXXXXXXXXXXXXXXXXXXXXXXXXX--XXXXXXXXXXXXX--XXXXXXXXXXXXXXXXXXXXXXXX--XXXXXXXXXXXXXXXXXXXXXXXXXXXXXXXXXXXXXXXXXXXXXXXXXXXXXXXXXXXXXXXXXXXXXXXXXXXXXXXXXXXX
--XXXXXXXXXXXXXXXXXXXXXXXXXXXXXXXXXXXXXXXXXXXXXXXXXXXXXXXXXXXXXXXXXXXXXXXXX--XXXXXXXXXXXXX--XXXXXXXXXXXXXXXXXXXXXXXX-XXXXXXXXXXXXXXXXXXXXXXXXXXXXXXXXXXXXXXXXXXXXXXXXXXXXXXXXXXXXXXXXXXXXXXXXXXXXXXXXXXXXX
