----------------------------------------------------------------------------------------------------------------------------------------------------------------------------------------------------------
----------------------------------------------------------------------------------------------------------------------------------------------------------------------------------------------------------
----------------------------------------------------------------------------------------------------------------------------------------------------------------------------------------------------------
----------------------------------------------------------------------------------------------------------------------------------------------------------------------------------------------------------
----------------------------------------------------------------------------------------------------------------------------------------------------------------------------------------------------------
----------------------------------------------------------------------------------------------------------------------------------------------------------------------------------------------------------
----------------------------SSSSSSSS-----------------------###----------------------------------------------------------------------------------------------------------!-------------------SS------------
----------------------------------------------------------###---------------------------------------------------------------------------------------------------------------------------------------------
---------------------------------------------------------####---------------------------------------------------------------------------------------------------------------------------------------------
---------------------------------------------------------####---------------------------#-----------------------------------------------------------------------------------------------------------------
-------------------SS------SS@---S!---------------------#####---##-------------S!--------#---------------!------------S!-----#-------------------------------------------t------------#-------------------
--------------------------------------#----------------######----t--------t---------##---##---------------------t---------#--##----------t-------------------------------t-----------##-------------------
-------------------------------------##--##-----------#######---##--------t--------###---###--------------------t--------##--###-----------------------------------------t-#--------###----------#--------
-----------------g---------g--------###--##---------#########---##----g---t-#---g-####---####-------#------g-g--t-------###--####---g--g--------------t------------------t-##------####----------t--------
XXXXXXXXXXXXXXXXXXXXXXXXXXXXXXXXXXXXXXX--XXXXXXXXXXXXXXXXXXXX---XXXXXXXXXXXXXXXXXXXXXXX-XXXXXXXX--XXXXXXXXXXXXXXXXXXXXXXXXX--XXXXXXXXXXXXX--XXXXXXXXXXXXXXXXXXX-#X---XXXXXXXXXXXXXXXXXXXXXXXXXXXXXXXXXXXXX
XXXXXXXXXXXXXXXXXXXXXXXXXXXXXXXXXXXXXXX--XXXXXXXXXXXXXXXXXXXXX--XXXXXXXXXXXXXXXXXXXXXXX--XXXXXXX--XXXXXXXXXXXXXXXXXXXXXXXXX--XXXXXXXXXXXXX--XXXXXXXXXXXXXXXX-XX-XX---XXXXXXXXXXXXXXXXXXXXXXXXXXXXXXXXXXXXX
