----------------------------------------------------------------------------------------------------------------------------------------------------------------------------------------------------------
----------------------------------------------------------------------------------------------------------------------------------------------------------------------------------------------------------
----------------------------------------------------------------------------------------------------------------------------------------------------------------------------------------------------------
----------------------------------------------------------------------------------------------------------------------------------------------------------------------------------------------------------
----------------------------------------------------------------------------------------------------------------------------------------------------------------------------------------------------------
----------------------------------------------------------------------------------------------------------------------------------------------------------------------------------------------------------
-------SSSSS-----------------------------------------------------------SSS--------------------------------------------------------------------------SSSSS-------------------------------------------------
-----------------------------------------------------------------------------------------------#----------------------------------------------------------------------------------------------------------
----------------------------------------------------------------------------------------------------------------------------------------------------------------------------------------------------------
-----------------------------------------------------------------------------------------------------------------------------------------------------------------------------#----------------------------
--------------------tt----#----------S---------------------------#----------------------------@--------t----S!-----------------------SUSS----t-----S!-------SUS----SS----#--##---!-------------##---------
------#-------------tt---tt--------------tt-------------t--------t--------#----------------------------t-------------------------------------t-------------------------###--##----------------####--------
-----##-------------tt---tt--------------tt-------------t--------t--------t---------tt----t------##----t-------------------------------------t------------------------####--##-------------#-#####--------
#---###-------g-----tt---tt----------@---tt--------g----t-#------t---g----t---------tt----t-----####---t-------------------------------------t-----------------------#####--##--------g----t########--g---
XXXXXXXXXXXXXXXXXXXXXXXXXXXXXXXXXXXXXXXXXXXXXXXXXXXXXXXXXXXXXXXXXXXXXXXXXXXXXXXXXXXXXXXXXXXXXXXXXXXXXXXXXXXXXXXXXX---XXXXXXXXXXXXXXXXXXXXXXXXXXXXXXXXXXXXXXXXXXXXXXXXXXXXX--XXXXXXXXXXXXXXXXXXXXXXXXXXXXXX
XXXXXXXXXXXXXXXXXXXXXXXXXXXXXXXXXXXXXXXXXXXXXXXXXXXXXXXXXXXXXXXXXXXXXXXXXXXXXXXXXXXXXXXXXXXXXXXXXXXXXXXXXXXXXXXXXXX--XXXXXXXXXXXXXXXXXXXXXXXXXXXXXXXXXXXXXXXXXXXXXXXXXXXXX--XXXXXXXXXXXXXXXXXXXXXXXXXXXXXX
