----------------------------------------------------------------------------------------------------------------------------------------------------------------------------------------------------------
----------------------------------------------------------------------------------------------------------------------------------------------------------------------------------------------------------
----------------------------------------------------------------------------------------------------------------------------------------------------------------------------------------------------------
----------------------------------------------------------------------------------------------------------------------------------------------------------------------------------------------------------
----------------------------------------------------------------------------------------------------------------------------------------------------------------------------------------------------------
----------------------------------------------------------------------------------------------------------------------------------------------------------------------------------------------------------
----------------!SSS--------------------#!SS--------------------------------------------------------S--!---------SS--------------------------------------SSS-------------------------------SSSSS----------
---------------------------------------#--------------------------S!S-------------------------------------------------------------------------------------------------------------------------------------
--------------------------------------##------------------------------------------------------------------------------------------------------------------------------------------------------------------
-------------------------------------###------------------------------------------------------------------------------------------------------------------##---------#------------------------------------
------------------!-------S@SS-----#####--------------SSSSS!S---SS---------!-----------------------------------#S!-tt--------------------------U-----!---####------##S------------------------tt----------
-----tt---------------------------######---------------------------------------------------------------tt-----------t------t----------------------------#####-----###-------------------------tt-------t--
-----tt--------------------------#######---------------------------------------------------------------tt-----------t------t-------------tt------------#######---####------------------tt------t-------t--
##---tt-------------------------########----------------------------##--------t----------g-------------tt-----------t------t-------------tt-----------########--#####-g----g-----------t-------t-------t--
XXXXXXXXXXXXXXXXXXXXXXXXXXXXXXXXXXXXXXXXXXXXXXXX--XXXXXXXXXXXXXXXXXXXXXXXXXXXXXX--XXXXXXXXXXXXXXX--XXXXXX--XXXXXXXXXXXXXXXXXXXXXXXXXXXXXXXXXXXXXXXXXXXXXXXXXXXXXXXXXXXXXXXXXXXXXXXXXXXXXXXXXXXXXXXXXXXXXXX
XXXXXXXXXXXXXXXXXXXXXXXXXXXXXXXXXXXXXXXXXXXXXXXX--XXXXXXXXXXXXXXXXXXXXXXXXXXXXXX--XXXXXXXXXXXXXXX--XXXXXX--XXXXXXXXXXXXXXXXXXXXXXXXXXXXXXXXXXXXXXXXXXXXXXXXXXXXXXXXXXXXXXXXXXXXXXXXXXXXXXXXXXXXXXXXXXXXXXX
