----------------------------------------------------------------------------------------------------------------------------------------------------------------------------------------------------------
----------------------------------------------------------------------------------------------------------------------------------------------------------------------------------------------------------
----------------------------------------------------------------------------------------------------------------------------------------------------------------------------------------------------------
----------------------------------------------------------------------------------------------------------------------------------------------------------------------------------------------------------
----------------------------------------------------------------------------------------------------------------------------------------------------------------------------------------------------------
----------------------------------------------------------------------------------------------------------------------------------------------------------------------------------------------------------
----------------SSS!SSSSSS----------SSS-------##---------------------------------------!SS------------------------SSSSS----------------------------------------------------------------------------SSSS---
----------------------------------------------##-----------------------------------------------------------#----------------------------------------------------------------------------------------------
---------------------------------------------###----------------------------------------------------------##------------------------#---------------------------------------------------------------------
---------------------------------------------#####----------------------------------#--------------------##------------------------##-----------------------------#---------------------------------------
----------------!!---------------------------#####-------!------U-----#------------##--------------------###---SSSSSS-------------###----U---S!----------S-------##----------t--------------------S#S-----
--------------------------------------------######--#----------------tt-----------###---------------------###---------------------###--------------------------####----------t----------------------------
-------------------------------------------#######--##----------------t----------####---------t-------##--###-------------------#####--------------t----------#####----------t----tt---------------------#
##-----------------------------------------#######--##----------------t----------####---------t----#####--####-----------g-----#1#####-------------t-g-------#######---------t----tt----------g---------##
XXXXX---XX--XXXXXXXXXXXXXXX--XXXXXXXXXXX--XXXXXXXX--XXXXXXXXXXXXXXXXXXXXXXXXXX--XXXXXXXXXXXXXXXXXXXXXXXXX-XXXXXXXXXXXXXXXXXX---XXXXXXXXXXXXXXXXXXXXXXXXXXXXXXXXXXXXXXXXXXXXXXXXXXXXXXXXXXXXXXXXXXXXXXXXXXX
XXXXX---XXXXXXXXXXXXXXXXXXX--XXXXXXXXXXX--XXXXXXXX--XXXXXXXXXXXXXXXXXXXXXXXXXX--XXXXXXXXXXXXXXXXXXXXXXXXX-XXXXXXXXXXXXXXXXXXX--XXXXXXXXXXXXXXXXXXXXXXXXXXXXXXXXXXXXXXXXXXXXXXXXXXXXXXXXXXXXXXXXXXXXXXXXXXX
