----------------------------------------------------------------------------------------------------------------------------------------------------------------------------------------------------------
----------------------------------------------------------------------------------------------------------------------------------------------------------------------------------------------------------
----------------------------------------------------------------------------------------------------------------------------------------------------------------------------------------------------------
----------------------------------------------------------------------------------------------------------------------------------------------------------------------------------------------------------
----------------------------------------------------------------------------------------------------------------------------------------------------------------------------------------------------------
----------------------------------------------------------------------------------------------------------------------------------------------------------------------------------------------------------
------------------------SSSSS-------------------------------------@----------------------------SS-------------------SSSS-------------SSSS--S---------SSSSSSSSSSSSS------------SSSSS-----!S----------------
----------------------------------------------------------------------------------------------------------------------------------------------------------------------------------------------------------
----------------------#-----------------------------------------------------------------------------------------------------------------------------------------------#-----------------------------------
---------------------##----------------------------------------------------------------------------------------------------------------------------------------------##-----------------------------------
-----SS-------------###-------#----#------------#---------------!-----------------------------S----S@-----tt--------------------SU------S--------S@S----------!!----###-------SS----S---------------S-----
-------------------####------##----##--------------------t-------------------------------------------------t-------------------------------------------------------#####----------------------------------
---------------t--####------####---###-------------------t------------------------------S#--#--------------t-------------t-----------------------------##---------######----------------------------------
------gg--##---#-######----######--####------------------t------g------------g----------S##--#-------------t-------------t----------------------------####-------#######--#------------t------------------
XXXXXXXXXXXX--XXXXXXXXXXXXXXXXXXX-XXXXXXXXXXXXXXXXXXXXXXXXXXXXXXXXXXXXXXXXXXXXXXXXXXXXXXXXXXXXXXXXXXXXXXXXXXXXXXXXXXXXXXXXXXXXXXXXXXXXXXXXXXXXXXXXXXXXXXXXXXXXXXXXXXXXXXXXXXXXXXXXXXXXXXXXXXXXXXXXXXXXXXXX
XXXXXXXXXXXX--XXXXXXXXXXXXXXXXXXXXXXXXXXXXXXXXXXXXXXXXXXXXXXXXXXXXXXXXXXXXXXXXXXXXXXXXXXXXXXXXXXXXXXXXXXXXXXXXXXXXXXXXXXXXXXXXXXXXXXXXXXXXXXXXXXXXXXXXXXXXXXXXXXXXXXXXXXXXXXXXXXXXXXXXXXXXXXXXXXXXXXXXXXXX
