----------------------------------------------------------------------------------------------------------------------------------------------------------------------------------------------------------
----------------------------------------------------------------------------------------------------------------------------------------------------------------------------------------------------------
----------------------------------------------------------------------------------------------------------------------------------------------------------------------------------------------------------
----------------------------------------------------------------------------------------------------------------------------------------------------------------------------------------------------------
----------------------------------------------------------------------------------------------------------------------------------------------------------------------------------------------------------
------------------------------------------------------------------------#---------------------------------------------------------------------------------------------------------------------------------
-----------------------------SSSSSS------------###--------------------###-----SSSSSSS---------SS----------------------------------------------------------------------------------------------------------
----------------------------------------------####-------------------##-----------------------------------------------------------------------------------------------------------------------------------
----------------------------------------------#####------------------##----------------------------------------------------------------------------------------------------------------------------#------
-------------------------SS------------------######------------------##--------------------------------------------------------------------------------------------------------------------------##S#-----
------##--------------------------SU---!----#######--------#SS-----####-------------t-----S----SS-------------S!S-------------S!S!----------------S@----------!------------S---------------------##S##----
-----####----tt-----------------------------#######---------------#####-------------t-------------------tt--------------------------------------------------------------------------------------##--##----
----#####-----t-----t----------------------########---------------#####---t--------tt-------------------tt----------------------------t------------------t------------t--------------t---------########---
-#-#######----t-#---t----------g----------#########--------------######---t------g--t-------------------tt--------------g-------------t------------------t-------g----t--------------t--------#########---
XXXXXXXXXXXXXXXXXXXXXXXXXXXXXXXXXXXXXXXXXXXXXXXXXXXXXXXXXXXXXXXXXXXXXXXXXXXXXXXXXXXXXXXXXXXXXXXXXXX--XXXXXXXXXXXXXXXXXXXXXXXXXXXXXXXXXXXXXXXXXXXXXXXXXXXXXXXXXXXXXXXXXXXXXXXXXXXXXXXXXXXXXX---XXXXXXXXXXXX
XXXXXXXXXXXXXXXXXXXXXXXXXXXXXXXXXXXXXXXXXXXXXXXXXXXXXXXXXXXXXXXXXXXXXXXXXXXXXXXXXXXXXXXXXXXXXXXXXXX--XXXXXXXXXXXXXXXXXXXXXXXXXXXXXXXXXXXXXXXXXXXXXXXXXXXXXXXXXXXXXXXXXXXXXXXXXXXXXXXXXXXXXX---XXXXXXXXXXXX
