----------------------------------------------------------------------------------------------------------------------------------------------------------------------------------------------------------
----------------------------------------------------------------------------------------------------------------------------------------------------------------------------------------------------------
----------------------------------------------------------------------------------------------------------------------------------------------------------------------------------------------------------
----------------------------------------------------------------------------------------------------------------------------------------------------------------------------------------------------------
----------------------------------------------------------------------------------------------------------------------------------------------------------------------------------------------------------
-----------------------------------------------------------------------------#--------------------------------------#-------------------------------------------------------------------------------------
---------------------------------------------------------------------------------SS---------------------------------#--------------SSSSSSSS-------------------------SSSSS---------------#-----------------
-------------------------------------------------------------------------------------------------------------------##-----------------------------------------------------------------####----------------
------------------------------------------------------------------------------------------------------------------###----------------------------------------------------------------###1-----------------
-----------------------------------------------------------------------------------------------------------------####---------------------------------------------------------------###1#-----------------
-------------------S!SS-----S-----------------SS-----S!SS!S----------------------------------t----U----!--------#####--------------------SSSS-------------------t-------SS---------###11#---##-----t------
----------t----------------------------------------------------------------------------------t-----------------######-------------------------------------------t------------t----#####1##--##-----t------
---------tt-------------------------tt------------------------------------------#-#----------t----------------########-------------------------tt---------------t-----------------######1---##-----t------
---------tt--------------------------t-------------------------------g--g---##---##------g---t------g--------##########-------g----g------------t---------------t--------------#U#########--###----t------
XXXXXXXXXXXXXXXXXXXXXXXXXXXXXXXXXXXXXXXXXXXXXXXXX--XXXXXXXXXXXXXXXXXXXXXXXXXXXXXXXXXXXXXXXXXXXXXXXXXXXXXXXXXXXXXXXXXXXXXXX--XXXXXXXXXXXXXXXXXXXXXXXXXXXXXXXXXXXXXXXXXXXXXXXXXXXXXXXXXXXXXXXXXXXXXXXXXXXXXX
XXXXXXXXXXXXXXXXXXXXXXXXXXXXXXXXXXXXXXXXXXXXXXXXX--XXXXXXXXXXXXXXXXXXXXXXXXXXXXXXXXXXXXXXXXXXXXXXXXXXXXXXXXXXXXXXXXXXXXXXX--XXXXXXXXXXXXXXXXXXXXXXXXXXXXXXXXXXXXXXXXXXXXXXXXXXXXXXXXXXXXXXXXXXXXXXXXXXXXXX
