----------------------------------------------------------------------------------------------------------------------------------------------------------------------------------------------------------
----------------------------------------------------------------------------------------------------------------------------------------------------------------------------------------------------------
----------------------------------------------------------------------------------------------------------------------------------------------------------------------------------------------------------
----------------------------------------------------------------------------------------------------------------------------------------------------------------------------------------------------------
----------------------------------------------------------------------------------------------------------------------------------------------------------------------------------------------------------
----------------------------------------------------------------------------------------------------------------------------------------------------------------------------------------------------------
------SSSSS---SSSSSSSSS---------------@---------------------------------------SS!-----------------SSS--------------!-----------------------#--------------------------------------------------------------
------------------------------------------------------------------------------------------------------------------------------------------##--------------------------------------------------------------
------------------------------------------------------------------------------------------------------------------------------------------##--------------------------------------------------------------
-----------------------------------------------------------------------------------------------------------------------------------------###--------------------------------------------------------------
----------S----------------------------t------------------------------t-------S!---------------------!---------------------------------SS###-----------------S--------------------------------------------
---------------------------------------t------------------------------t----------------------------------------#--#----tt----------------###----------------------------------------------------##--------
---------------------------------------t------------------------------t---------------------------------------##--##---t----------------####---------------------t--------t--------------------#####------
-------------------g----g---------g----t----------g-------------------t--------------------##----------------###--##---t-------t-------#####------g----------g---t###----tt-------------------######------
XXXXXXXXXXXXXXXXXXXXXXXXXXXXXXXXXXXXXXXXXXXXXXXXXXXXXXXXXXXXX--XXXXXXXXXXXXXXXXXXXXXXXXXXXXXXXXXXXXXXXXXXXXXXXXXXXXXXXXXXXXXXXXXX--XXXXXXXXXXXXXXXXXXXXXXXXXXXXXXXXXXXXXXXXXXXXXXXXXXXXXXXXXXXXXXXXXXXXXXX
XXXXXXXXXXXXXXXXXXXXXXXXXXXXXXXXXXXXXXXXXXXXXXXXXXXXXXXXXXXXX--XXXXXXXXXXXXXXXXXXXXXXXXXXXXXXXXXXXXXXXXXXXXXXXXXXXXXXXXXXXXXXXXXX--XXXXXXXXXXXXXXXXXXXXXXXXXXXXXXXXXXXXXXXXXXXXXXXXXXXXXXXXXXXXXXXXXXXXXXX
