----------------------------------------------------------------------------------------------------------------------------------------------------------------------------------------------------------
----------------------------------------------------------------------------------------------------------------------------------------------------------------------------------------------------------
----------------------------------------------------------------------------------------------------------------------------------------------------------------------------------------------------------
----------------------------------------------------------------------------------------------------------------------------------------------------------------------------------------------------------
----------------------------------------------------------------------------------------------------------------------------------------------------------------------------------------------------------
----------------------------------------------------------------------------------------------------------------------------------------------------------------------------------------------------------
--------------------------------------------------------------------S!SS--------------------------------------------------------------------------#----#S-------------------!---------#-------------------
-----------------------------------------------------------------------------------------------------------##------------------------------------------------------------------------##-------------------
---------------------------------------------------------------------------------------------------------#-####---------------------------------------------------------------------##--------------------
--------------------------------------------------------------------------------------------------------##S#####---------------------------------#---------------------------------###--------------------
----------S!----------------S@!----------------##--!-----tt-----##-----------------------------t------##########-------------------------U------##--S@S--##----SSSS----t----S-----####---------------!----
----------------------------------------------###--------t-----###-----------------------------t------##########------------t------------------###-------##------------t----------####--------------------
-------------------#---##--------------------####--------tt---####-----------------------------t-----###########------------t-----------------####------###------------t---------#####--------------------
------------------##---###-----------------######--------tt--S####-------#--------------------tt----############------------t----g-----------#####-----####------------t--------######--------------------
XXXXXXXXXXXXXXXXXXXXX--XXXXXXXXXXXXXXXXXXXXXXXXXXXXXXXXXXXXXXXXXXXXXXX---XXXXXXXXXXXXXXXXXXXXXXXXXXXXXXXXXXXXXXXXXXXXXXXXXXXXXXXXXXXXXXXXXXXXXXXXXXXXXXXXXXXXXXXXXXXXXXXXXXXXXXXXXXXXXXXXXXXXXXXXXXXXXXXXX
XXXXXXXXXXXXXXXXXXXXX--XXXXXXXXXXXXXXXXXXXXXXXXXXXXXXXXXXXXXXXXXXXXXXX---XXXXXXXXXXXXXXXXXXXXXXXXXXXXXXXXXXXX-XXXXXXXXXXXXXXXXXXXXXXXXXXXXXXXXXXXXXXXXXXXXXXXXXXXXXXXXXXXXXXXXXXXXXXXXXXXXXXXXXXXXXXXXXXXX
