----------------------------------------------------------------------------------------------------------------------------------------------------------------------------------------------------------
----------------------------------------------------------------------------------------------------------------------------------------------------------------------------------------------------------
----------------------------------------------------------------------------------------------------------------------------------------------------------------------------------------------------------
----------------------------------------------------------------------------------------------------------------------------------------------------------------------------------------------------------
----------------------------------------------------------------------------------------------------------------------------------------------------------------------------------------------------------
----------------------------------------------------------------------------------------------------------------------------------------------------------------------------------------------------------
------------!-------S!S-----------------------------------------------------------------------------------SSSSSSS-----------------SSSSSSS--------------SSSSSS-----S!--------------------SS----------------
------------------------------------------------------------------------------------------------------------------------------------------------------------#---------------------------------------------
--------------##-------------------------------------------------------------------------------------------------------------------------------#------------#--------------------#------------------------
-----------#-###------------------------------------------------------------------------------------#SSS-------------------------------------###-----------##-------#-----------##------------------------
-----------#####--------------@----------S-----------------------!!-----------------------------------------------!-------------------------####----------##-------------------###--------S!SS------------
----------######-------------------------###--------------------------------------------------------------------------------------t--------#####----------##------------------####------------------------
---------#########-----------------------#####-------------------------#--------------------tt------------------------------------t-------######---------###-----------------######-----------------------
--#-----##########-----------------------######-----------g-----------###--------------g----tt----------#-------------------------t------#######---------####---------------########---------------------#
XXX--XXXXXXXXXXXXXXXXXXXXXXXXXXXXXXXXXXXXXXXXXXXXXXXXXXXXXXXXXXXXXXX--XXXXXXXXXXXXXXXXXXXXXXXXXXXXX--XXXXXXXXXXXXXXXXXXXXXXXXXXXXXXXXXXXXXXXXXXXXXXX--XXXXXXXXXXXXXXXXXXXXXXXXXXXXXXXXXXXXXXXXXXXXXXXXXXXX
XXX--XXXXXXXXXXXXXXXXXXXXXXXXXXXXXXXXXXXXXXXXXXXXXXXXXXXXXXXXXXXXXXX--XXXXXXXXXXXXXXXXXXXXXXXXXXXXX--XXXXXXXXXXXXXXXXXXXXXXXXXXXXXXXXXXXXXXXXXXXXXXX--XXXXXXXXXXXXXXXXXXXXXXXXXXXXXXXXXXXXXXXXXXXXXXXXXXXX
