----------------------------------------------------------------------------------------------------------------------------------------------------------------------------------------------------------
----------------------------------------------------------------------------------------------------------------------------------------------------------------------------------------------------------
----------------------------------------------------------------------------------------------------------------------------------------------------------------------------------------------------------
----------------------------------------------------------------------------------------------------------------------------------------------------------------------------------------------------------
----------------------------------------------------------------------------------------------------------------------------------------------------------------------------------------------------------
----------------------------------------------------------------------------------------------------------------------------------------------------------------------------------------------------------
-----------------------------------------------------------------------------SS!----------------------------------------------------------------------------SS-------SSSSSS-------------------------------
----------------------------------------------------------------------------------------------------------------------------------------------------------------------------------------------------------
----------------------------------------------#-----------------------------------------------------------------------------------------------------------------------------------------------------------
---------------------------------------------##-----------------------------------------------------------------------------------------------------------------------------------------------------------
----------------!--------------------!------###-----------##-----#--------!S--@----------t-----------S!--------#--------t-------SUS--------#S-----------S@----t----SSSS--------#--#----------------t------
-------------------------------------------####-------##-####----t------------------------------t--------------t--------#-------------------------------------t---------------##--##---------------t------
--------------------------##-----t--------#####------########----t---tt-------------##----------t------t-------t--------#-------------------------------------t--------------###--###--------------t------
-----------------------#--###----t-------######-----#########----t---tt----g--------##---###----t-#----t----g--t--------t-------------------------------------t##-----------####---##---------g----t------
XXXXXXXXXXXXXXXXX--XXXXX--XXXXXXXXXXXXXXXXXXXXXXXXXXXXXXXXXXX---XXXXXXXXXXXXXXXXXXXXXX--XXXXXXXXXXXXXXXXXXXXXXXXXXXXXXXXXXXXXXXXXXXXXXXXXXXXXXXXXXXXXXXXXXXXXXXXXXXXXXXXXXXXXXXX--XXXXXXXXXXXXXXXXXXXXXXXX
XXXXXXXXXXXXXXXXX--XXXXXXXXXXXXXXXXXXXXXXXXXXXXXXXXXXXXXXXXXX---XXXXXXXXXXXXXXXXXXXXXXX-XXXXXXXXXXXXXXXXXXXXXXXXXXXXXXXXXXXXXXXXXXXXXXXXXXXXXXXXXXXXXXXXXXXXXXXXXXXXXXXXXXXXXXXX--XXXXXXXXXXXXXXXXXXXXXXXX
