----------------------------------------------------------------------------------------------------------------------------------------------------------------------------------------------------------
----------------------------------------------------------------------------------------------------------------------------------------------------------------------------------------------------------
----------------------------------------------------------------------------------------------------------------------------------------------------------------------------------------------------------
----------------------------------------------------------------------------------------------------------------------------------------------------------------------------------------------------------
----------------------------------------------------------------------------------------------------------------------------------------------------------------------------------------------------------
----------------------------------------------------------------------------------------------------------------------------------------------------------------------------------------------------------
-------------------------------------SSSSSS---SS-------------------------S!SSSS--------------------------------------------------------SSSSS--------------------------------SSS-----------###-------------
------------------------------------------------------------------------------------------------------------------------------------------------------------------------------------------###-------------
------------------------------------------------------------------------------#----------------------------------------------------------------------------------------------------------####-------------
-----------------------------------------------------------------------------##--------------------------------------------#-------------------------------------------------------------###--------------
-----------------------S@S--------------S!S---t----#--U----------------SS---###------------!------SSSSSS!S----------------##---------!----S-----------t----------------SSSS------------SSSS#S-------------
------------------------------##---t----------t---##-----------------------####--------------------------------t---------#####------------------------t------------------------##-------------------------
---------tt--------#--#------###---t----------t--###----------------------#####-##-----------------------------t--------######------------------------t-----------------------###--------------------#----
---------tt--------#-##-----####---t----------t-####----g----------------#########-----------#-##-#------------t-------########-----------------------t----------------------#####g------------------##---
XXXXXXXXXXXXXXXXXXXXXXXXXXXXXXXXXXXXXXXXXXXXXXXXXXXXXXXXXXXXXXXXXXXXXXXXXXXXXXXXXXXXXXXXXXXXXXXXXXXXXXXXXXXXXXXXXXXXXXXXXXXXXXXXXXXXXXXXXXXXXXXXXXXXXXXXXXXXXXXXXXXXXXXXXXXXXXXXXXXXXXXXXXXXXXXXXXXXXXXXXX
XXXXXXXXXXXXXXXXXXXXXXXXXXXXXXXXXXXXXXXXXXXXXXXXXXXXXXXXXXXXXXXXXXXXXXXXXXXXXXXXXXXXXXXXXXXXXXXXXXXXXXXXXXXXXXXXXXXXXXXXXXXXXXXXXXXXXXXXXXXXXXXXXXXXXXXXXXXXXXXXXXXXXXXXXXXXXXXXXXXXXXXXXXXXXXXXXXXXXXXXXX
