----------------------------------------------------------------------------------------------------------------------------------------------------------------------------------------------------------
----------------------------------------------------------------------------------------------------------------------------------------------------------------------------------------------------------
----------------------------------------------------------------------------------------------------------------------------------------------------------------------------------------------------------
----------------------------------------------------------------------------------------------------------------------------------------------------------------------------------------------------------
----------------------------------------------------------------------------------------------------------------------------------------------------------------------------------------------------------
-------------------------------------------------------------------------------------------------------------g--------------------------------------------------------------------------------------------
------------------------------------------!SS--------------------------------------------------------------SSSSSSSSSS----------------------------------------------------------------SSSSSS!SS---SSSSSSS--
----------------------------------------------------------------------------------------------------------------------------------------------------------------------------------------------------------
--------------------------------------------------------------------------------------------#--------------------------------------------------------------------------------------------#----------------
------------------------------------------------------------------------------------------###-------------------------------------------------------------------------------------------------------------
----#----#---------!-!-------------SSSS--------------!----------S!----!------S----!-----#####-------------------------------------S!-----------------------------SS---------------------1--------S!-------
--------------------------t------------------------------------------------------------######---###---------------------------------------t-----------------t-------------------------##1-----------------
----t----------t----------t------#----------------------------------------------------#######---###-------t---t---------------------------t-----------------t------------------------####-----------------
----t-#--------t------g---t-##--###--g-----------------g---#-------------gg----------########---#####-----t---tt#-------------------------t-----------------t---------------------#######-----gg----------
XXXXXXXXXXXXXXXXXXXXXXXXXXXXXXXXXXXXXXXXXXXXXXX---XXXXXXXXXXXXXXXXXXXXXXXXXXXXXXXXXXXXXXXXXXXXXXXXXXXXXXXXXXXXXXXXXXXXXXXXXXXXXXXXXXXXXXXXXXXXXXXXX--XXXXXXXXXXXXXXXXXXXXXXXXXXXXXXXXXXXXXXXXXXXXXXXXXXXXX
XXXXXXXXXXXXXXXXXXXXXXXXXXXXXXXXXXXXXXXXXXXXXXX---XXXXXXXXXXXXXXXXXXXXXXXXXXXXXXXXXXXXXXXX-XXXXXXXXXXXXXXXXXXXXXXXXXXXXXXXXXXXXXXXXXXXXXXXXXXXXXXXX--XXXXXXXXXXXXXXXXXXXXXXXXXXXXXXXXXXXXXXXXXXXXXXXXX-XXX
