----------------------------------------------------------------------------------------------------------------------------------------------------------------------------------------------------------
----------------------------------------------------------------------------------------------------------------------------------------------------------------------------------------------------------
----------------------------------------------------------------------------------------------------------------------------------------------------------------------------------------------------------
----------------------------------------------------------------------------------------------------------------------------------------------------------------------------------------------------------
----------------------------------------------------------------------------------------------------------------------------------------------------------------------------------------------------------
----------------------------------------------------------------------------------------------------------------------------------------------------------------------------------------------------------
------------------------------------------------------------------####------------------------SSSSSSS--------------------------------------------------------------------------S!SSSSS--------------------
-----------------------------------------------------------------####-------------------------------------------------------------------------------------------------------------------------------------
-----------------------------------------------------------------###--------------------------------------------------------------------------------------------------------------------------------------
-------------#---------------------------------------------------##------------------------------------------------------------------------------------------------------!----------------------##--------
------------##----------S!S!------#-------------S------!---S!S-SS!1----S-----@-------------------S------------t---------#!--------------------------t--------------t--------------------@---#--####-------
-----------###--------------------t-----------------------------------------------------t---------------------t-------------------------------------t------tt------t-----------------------##-#####-------
----------####--------------------t-----------------------------------------------------t---------------------t-----##---------------###------------t------tt------t-----------------------########---tt--
---------######-------------------t---------------gg------------------------------------t---------------------t-----SS#--gg------#---###-------g----t-------t------t----------------------#########---t---
XXXXXXXXXXXXXXXXXXXXXXXXXXXXXXXXXXXXXXXXXXXXXXXXXXXXXXXXXXXXXXXXXXXXXXXXXXXXXXXXXXXXXXXXXXXXXXXXXXXXXXXXXXXXXXXXXXXXXXXXXXXXXXXXXXXXXXXXXXXXXXXXXXXXXXXXXXXXXXXXXXXXX-----XXXXXXXXXXXXXXXXXXXXXXXXXXXXXXXX
XXXXXXXXXXXXXXXXXXXXXXXXXXXXXXXXXXXXXXXXXXXXXXXXXXXXXXXXXXXXXXXXXXXXXXXXXXXXXXXXXXXXXXXXXXXXXXXXXXXXXXXXXXXXXXXXXXXXXXXXXXXXXXXXXXXXXXXXXXXXXXXXXXXXXXXXXXXXXXXXXXXXX--X--XXXXXXXXXXXXXXXXXXXXXXXXXXXXXXXX
