----------------------------------------------------------------------------------------------------------------------------------------------------------------------------------------------------------
----------------------------------------------------------------------------------------------------------------------------------------------------------------------------------------------------------
----------------------------------------------------------------------------------------------------------------------------------------------------------------------------------------------------------
----------------------------------------------------------------------------------------------------------------------------------------------------------------------------------------------------------
----------------------------------------------------------------------------------------------------------------------------------------------------------------------------------------------------------
----------------------------------------------------------------------------------------------------------------------------------------------------------------------------------------------------------
------------------SSSS---#!U------------------------------------------------------------------SS----------------------------------------------------------------------------------------------------------
-------------------------------------------------------------------------------------------------------------------------------------S-------------------------------------------------------------##-----
--------------------------------------------------------------------------------------------------------------------------------------------------------------------------------------------------###-----
-------------------------------------------------------------------------------------------------------------------------------------------------------------------------------------------------#####----
---------U-------S!---SUSS--SS----------!--------------------------------------------------##------------------------------------------------S@!-----------------------!-------S@---------------######----
------------------------------------------------------------------------------------------###-----------------t---------#--#-------------------------------------------------------------------#######----
----t---------------------------------------!-----------------t---------------------------###---#-------------t--------###-##----------------------------#----------------------------t-------########----
----t###-----#-------------------g----------#-----------------t---------g---------#-#----####---#-------------t-------####-##--------g----g----------g---t------t---------------------t------#########----
XXXXXXXXXXXXXXXXXXXXXXXXXXXXXXXXXXXXXXXXXXXXXXXXXXXXXXXXXXXXXXXXXXXXXXXXXXXXXXXXXXXXX#--XXXXX--XXXXXXXXXXXXXXXXXXXXXXXXXXXXXXXXXXXXXXXXXXXXXXXXXXXXXXXXXXXXXXXXXXXXXXXXXXXX--XXXXXXXXXXXXXXXXXXXXXXXXXXXXX
XXXXXXXXXXXXXXXXXXXXXXXXXXXXXXXXXXXXXXXXXXXXXXXXXXXXXXXXXXXXXXXXXXXXXXXXXXXXXXXXXXXXXX--XXXXXX-XXXXXXXXXXXXXXXXXXXXXXXXXXXXXXXXXXXXXXXXXXXXXXXXXXXXXXXXXXXXXXXXXXXXXXXXXXXX--XXXXXXXXXXXXXXXXXXXXXXXXXXXXX
