----------------------------------------------------------------------------------------------------------------------------------------------------------------------------------------------------------
----------------------------------------------------------------------------------------------------------------------------------------------------------------------------------------------------------
----------------------------------------------------------------------------------------------------------------------------------------------------------------------------------------------------------
----------------------------------------------------------------------------------------------------------------------------------------------------------------------------------------------------------
----------------------------------------------------------------------------------------------------------------------------------------------------------------------------------------------------------
----------------------------------------------------------------------------------------------------------------------------------------------------------------------------------------------------------
-------------------------SSSS----------------------------------------------------------------------------------SS------------------------------------------------------------S----------------------------
--------------------------------------------------------------------SS------------------------------------------------------------------------------------------------------------------------------------
---------------------------#----@-------------------------------------------------------------------------------------------------------------------------------------------------------------------------
--------------------------###-----------------------------------------------------------------------------------------------------------------------------------------------------------------------------
-----SSSS----------------#####------------###--#---!------------S@S----t----------------------------S----------------------#-------------S!---------------------------------SUS----SSS--------------t-----
------------------------######-----------####--#-----------------------t----------------------------------------------------------------------------------------------------------------------------tt----
--------------t##-----########----------#####-##-----------------------t------------------------------------------tt--------------------------------------------------------------------------------tt----
--------------t##---##########---------#########-----------------------t-g-----------g-----g----#---------g-------tt----------------------------#---------g------------------------------g-----g----tt----
X-XXXXXXXXXXXXXXXXXXXXXXXXXXXXXXXXXXXXXXXXXXXXXXXXXXX---XX---XXXXXXXXXXXXXXXXXXXXXXXXXXXXXXXXXXXXXXXXXXXXXXXXXXXXXXXX---XXXXXXXXXXXXXXXXXXXXXXXXXXXXXXXXXXXXXXXXXXXXXXXXXXXXXXXXXXXXXXXXXXXX--XXXXXXXXXXXX
X-XXXXXXXXXXXXXXXXXXXXXXXXXXXXXXXXXXXXXXXXXXXXXXXXXXX---XX--XXXXXXXXXXXXXXXXXXXXXXXXXXXXXXXXXXXXXXXXXXXXXXXXXXXXXXXXX---XXXXXXXXXXXXXXXXXXXXXXXXXXXXXXXXXXXXXXXXXXXXXXXXXXXXXXXXXXXXXXXXXXXX-XXXXXXXXXXXXX
