----------------------------------------------------------------------------------------------------------------------------------------------------------------------------------------------------------
----------------------------------------------------------------------------------------------------------------------------------------------------------------------------------------------------------
----------------------------------------------------------------------------------------------------------------------------------------------------------------------------------------------------------
----------------------------------------------------------------------------------------------------------------------------------------------------------------------------------------------------------
----------------------------------------------------------------------------------------------------------------------------------------------------------------------------------------------------------
----------------------------------------------------------------------------------------------------------------------------------------------------------------------------------------------------------
----------------------------------------------------------------------------------------------------------------------------------------------------------------------------------------------------------
----------------------------------------------------------------------------------------------------------------------------------------------------------------------------------------------------------
------------------------------SSS-------------------------------------------------------------------------------------------------------------------------------------------------------------------------
---------------------------------------------------------------------------------S-----------------------------------------------------------------------------------------------------------#------------
----!--------!----------#----------------S!S----------------------S@S------S-------------------------------------------------SS----------------------SS!--------------!S-------------------###-----#------
------------------t-----t--------------------##-------------------------------------------------------------------------------------------##----------------------------------------------####------------
------------------t-----t--------------------###-------------t---------------------t----tt------tt------t----#--------t------------------####---------------------------------------------####------------
------------------t-----t-------------------####--g--g-------t---------------------t-----t------tt------t----t--------t------------------#####-----@-------------------------------------S#####-----------
XXXXXXXXXXXXXXXXXXXXXXXXXXXXXXXXXXXXXXXXXXXXXXXXXXXXXXXXXXXXXXXXXXXXXXXXXXXXXXXXXXXXXXXXXXXXXXXXXXXXXXXXXXXXXXXXXXXXXXXXXXXXXXXXXXXXXXXXXXXXXXXXXXXXXXXXXXXXXXXX--XXXXXX--XXXXX--XXXXXXXXXXXXXXXXXXXXXXXXX
XXXXXXXXXXXXXXXXXXXXXXXXXXXXXXXXXXXXXXXXXXXXXXXXXXXXXXXXXXXXXXXXXXXXXXXXXXXXXXXXXXXXXXXXXXXXXXXXXXXXXXXXXXXXXXXXXXXXXXXXXXXXXXXXXXXXXXXXXXXXXXXXXXXXXXXXXXXXXXXX--XXXXXX--XXXXX--XXXXXXXXXXXXXXXXXXXXXXXXX
