----------------------------------------------------------------------------------------------------------------------------------------------------------------------------------------------------------
----------------------------------------------------------------------------------------------------------------------------------------------------------------------------------------------------------
----------------------------------------------------------------------------------------------------------------------------------------------------------------------------------------------------------
----------------------------------------------------------------------------------------------------------------------------------------------------------------------------------------------------------
----------------------------------------------------------------------------------------------------------------------------------------------------------------------------------------------------------
----------------------------------------------------------------------------------------------------------------------------------------------------------------------------------------------------------
-----------!------------------------------------SSSSSSSSS---------------------------------------------!SSS-------SS-------------------------------SSSS-----SSSSSSSS---------------------------------------
----------------------------------------------------------------------------------------------------------------------------------------------------------------------------------------------------------
----------------------------------------------------------------------------------------------------------------------------------------------------------#-----------------------------------------------
------------------------##------------------------------------------------------------------------#----------------------------------------------------#--#------------------------------###--------------
---------------t---------#------------------S@S---------------------S@SS---#--------@------------####-------S!----##--#---------------@---------------#--##---!--------------@----------#####-#-----------
---------------t---------#---------------------------------------------------#-----------t------#####-------------##--#-----------------------#------##--##------------##--------------#####--##----------
---------------t------#####-------------------------------------------------##-----------t-----#####-------------######-----------------------##----#######------------###------------######--------------
---------------t-----######-----------##------------------------#------g---#####---------t----######------g-----#######----g------------------###--########------------###---g-------#######---#----------
XXXXXXXXXXXXXXXXXX--XXXXXXXXXXXXXX---XXXXXXXXXXXXXXXXXXXXXXXXXXXXXXXXXXXXXXXXXXXXXXXXXXXXXXXXXXXXXXXXXXXXXXXXXXXXXXXXXXXXXXXXXXXXXXXXXXXXXXXXXXXXXXXXXXXXXXXXXXXXXXXXXXXXXXXXXXXXX--XXXXXXXX--XXXX--XXXXXX
XXXXXXXXXXXXXXXXXXXXXXXXXXXXXXXXXX---XXXXXXXXXXXXXXXXXXXXXXXXXXXXXXXXXXXXXXXXXXXXXXXXXXXXXXXXXXXXXXXXXXXXXXXXXXXXXXXXXXXXXXXXXXXXXXXXXXXXXXXXXXXXXXXXXXXXXXXXXXXXXXXXXXXXXXXXXXXXXX-XXXXXXXX--XXXX--XXXXXX
